11111111
11111111
11CC1111
11E000P1
11111111

