11111111111
1C0000C1111
11CCCC11111
1E0000P1111
111CC111111
1C0000000C1
11111111111
