1111111111111111
1C000000000000C1
1111110P11111111
1111110E11111111
1C000000000000C1
1111111111111111
