11111111
11111111
110C1111
11E000P1
11111111
